.X..X.........X........
......2................
.................6.....
2...........3....1.....
.X4........X.X...1.....
.......2.......X.2.....
...X......X......2X....
2.2........X4..1.......
.......................
...X..3.........2......
1..X......2......3..X..
2XXX...........X.....X.