26 26
. . X . . 4 . . . . . . X . . . . . . . . . 2 . . .
. . . . . . . . 1 3 1 . . . . 2 . . . . . . . . . .
. 3 X . . . . . . . . . X . . . . . . . . . 3 . . .
. 2 . . . 4 . . . . . . . 1 . . . . . . X . . . 3 .
. . . . X . . . . . . . . . . . . . . . . . . . X .
. X . . . . . 2 . X . . 2 . . . . 3 . . . . . X . .
. . . 2 . . . . . . . . . . . X . . . . 1 . . . . .
. 5 . . . 7 . . . . 3 . . X . . . 12 . . . . 2 . . .
. . . . . . X . . . . . 5 . . . . . . 7 . . . . . .
. . X . . . . . . . . X . . . . . . . X . . . . . .
. . . . 4 . . . X . . . . . . 3 . . . . . . . 6 . .
. 1 1 . . . . . . . . 2 . . . . . . . 8 . . . . . .
. 1 1 . . X . . . . 1 . . X X . . . 4 . . . . X . .
. 3 . . . . . . . . . . . X X X . . . . . . . . . .
. . X . . 2 6 . . . . . . X X X . . . 3 . . 5 . . .
. . 11 . . . 3 . . . . . . . . . . . . . X . . . . .
. . . . . X . . . . . . . . . 4 . . . . . . . . . .
. . . 2 . . . . . X . . . . . X . . . . 3 . . . . .
. . . . . . 1 . . . . . . . 3 . . . . . . . . . . X
. . . X . . . . . . . X . . . . . . . 4 . . . . . X
. . . . . . 5 . . . . . . . . . . . X . . . . . . X
. . . . . . . . . . 1 3 . . . . . . . 5 . . . . . .
. . X . . 3 . . . . 3 1 . . . . 2 . . . . . . . 4 .
. . . . . . . . X . . . . . . . . . . 6 . . . X . .
. X . . . 2 . . . . . . . . . X . . 13 . . . . 2 . .
43 X . 1 . 2 . . . . . . . . 3 . . . . . X . 2 . . 1